только	только	ADV
можно	можно	ADJ	Sing, Neut
надо	надо	ADJ	Sing, Neut


нет	нет	VERB	Sing, 3
также	также	ADV
причем	причем	ADV
видно	видный	ADJ	Sing, Neut
итак	итак	ADV
вроде	вроде	ADV
блин	блин	INTJ
да	да	INTJ
почему	почему	INTJ
боже	боже	INTJ
с	с	NOUN
так	так	NOUN
нету	нету	VERB	Sing,3

старательно	старательно	ADV
традиционно	традиционно	ADV
эффективно	эффективно	ADV
безжалостно	безжалостно	ADV
поздно	поздно	ADJ	Sing, Neut
минимум	минимум	ADV
черт	черт	INTJ
машинально	машинально	ADV
ввиду	ввиду	ADV
до	до	NOUN
давай	давай	INTJ
непроизвольно	непроизвольно	ADV
здравствуйте	здравствуйте	INTJ

за	за	ADV
давайте	давайте	INTJ
пожалуйста		INTJ
супер		ADV
слышь		INTJ
ммм		INTJ
блядь		INTJ
напрокат		ADV
пуще		ADV
аминь		INTJ
классически	классически	ADV
жуть		ADV
пока		INTJ
